state,Month,Year,handgun,long_gun,other,Total Sales
California,Apr,2010,26170,27650,0,53820
California,Apr,2011,30345,29788,0,60133
California,Apr,2012,29500,30211,59,59770
California,Apr,2013,34701,42516,72,77289
California,Apr,2014,40847,29602,4030,74479
California,Apr,2015,35479,25542,4370,65391
California,Apr,2016,41862,30133,5247,77242
California,Apr,2017,45182,24898,3104,73184
California,Apr,2018,37814,25571,3736,67121
California,Apr,2019,37484,25895,4204,67583
California,Apr,2020,59219,31759,6330,97308
California,Apr,2021,44095,30019,7117,81231
California,Apr,2022,38217,25572,5595,69384
California,Apr,2023,35813,23385,5158,64356
California,Aug,2009,17376,21212,0,38588
California,Aug,2010,18686,22110,0,40796
California,Aug,2011,23431,27619,0,51050
California,Aug,2012,29494,31911,63,61468
California,Aug,2013,31020,39974,74,71068
California,Aug,2014,38710,30590,3454,72754
California,Aug,2015,33938,26257,3935,64130
California,Aug,2016,43344,43552,13186,100082
California,Aug,2017,41110,26220,3058,70388
California,Aug,2018,34617,25666,3117,63400
California,Aug,2019,36607,25247,3837,65691
California,Aug,2020,65196,38505,8409,112110
California,Aug,2021,41275,28433,5995,75703
California,Aug,2022,39236,25005,5743,69984
California,Aug,2023,32817,22053,4091,58961
California,Dec,2009,19496,27200,0,46696
California,Dec,2010,24519,32100,0,56619
California,Dec,2011,29452,36425,54,65931
California,Dec,2012,51731,73026,91,124848
California,Dec,2013,34360,70609,68,105037
California,Dec,2014,66770,47409,6956,121135
California,Dec,2015,74399,48762,9583,132744
California,Dec,2016,63649,93224,77929,234802
California,Dec,2017,47613,35240,4885,87738
California,Dec,2018,40445,34180,3808,78433
California,Dec,2019,40637,30780,4883,76300
California,Dec,2020,59909,39389,6932,106230
California,Dec,2021,46627,31488,5894,84009
California,Dec,2022,40213,28073,5523,73809
California,Feb,2010,19706,21016,0,40722
California,Feb,2011,24348,24119,0,48467
California,Feb,2012,30902,31877,72,62851
California,Feb,2013,38087,46026,97,84210
California,Feb,2014,39048,29728,4280,73056
California,Feb,2015,37478,27480,4417,69375
California,Feb,2016,44461,29486,5283,79230
California,Feb,2017,44363,24987,2898,72248
California,Feb,2018,38531,24768,3940,67239
California,Feb,2019,36424,22506,3932,62862
California,Feb,2020,35570,22645,4221,62436
California,Feb,2021,40789,27915,6499,75203
California,Feb,2022,36362,23017,4941,64320
California,Feb,2023,36098,21837,4641,62576
California,Jan,2010,18280,20059,0,38339
California,Jan,2011,23418,22708,0,46126
California,Jan,2012,25812,25757,59,51628
California,Jan,2013,51025,54527,96,105648
California,Jan,2014,33834,27585,3822,65241
California,Jan,2015,37560,23524,4060,65144
California,Jan,2016,52139,32970,7054,92163
California,Jan,2017,41516,22686,2898,67100
California,Jan,2018,37335,22919,3495,63749
California,Jan,2019,35861,23195,4035,63091
California,Jan,2020,34884,22057,4131,61072
California,Jan,2021,55103,36179,6807,98089
California,Jan,2022,36971,24010,5150,66131
California,Jan,2023,35181,21735,4949,61865
California,Jul,2009,18555,17211,0,35766
California,Jul,2010,19019,19505,0,38524
California,Jul,2011,21925,21196,0,43121
California,Jul,2012,26313,27530,52,53895
California,Jul,2013,29531,31564,75,61170
California,Jul,2014,34912,24482,3254,62648
California,Jul,2015,39980,27844,3995,71819
California,Jul,2016,46361,47594,17297,111252
California,Jul,2017,37027,21721,2514,61262
California,Jul,2018,30486,21136,3054,54676
California,Jul,2019,30400,20830,3485,54715
California,Jul,2020,67672,38618,7530,113820
California,Jul,2021,41996,26036,5945,73977
California,Jul,2022,41159,23489,6090,70738
California,Jul,2023,30198,18567,3953,52718
California,Jun,2009,20060,18949,0,39009
California,Jun,2010,17778,18802,0,36580
California,Jun,2011,24632,24012,0,48644
California,Jun,2012,26514,27427,87,54028
California,Jun,2013,29702,35007,78,64787
California,Jun,2014,34232,24557,3818,62607
California,Jun,2015,33287,22795,3763,59845
California,Jun,2016,43042,37512,10673,91227
California,Jun,2017,42726,23807,2763,69296
California,Jun,2018,32684,23612,3921,60217
California,Jun,2019,38712,27050,4856,70618
California,Jun,2020,76210,40933,8487,125630
California,Jun,2021,42689,28180,7523,78392
California,Jun,2022,43113,27018,7422,77553
California,Jun,2023,33746,21016,4539,59301
California,Mar,2010,23487,25449,0,48936
California,Mar,2011,29994,30323,0,60317
California,Mar,2012,36137,38797,74,75008
California,Mar,2013,38013,48181,80,86274
California,Mar,2014,45089,34352,4833,84274
California,Mar,2015,38597,30120,3822,72539
California,Mar,2016,45266,31454,6007,82727
California,Mar,2017,48732,27839,3032,79603
California,Mar,2018,47425,32189,4802,84416
California,Mar,2019,42551,28146,4299,74996
California,Mar,2020,81543,48616,5041,135200
California,Mar,2021,50271,35334,7327,92932
California,Mar,2022,43976,29658,6490,80124
California,Mar,2023,40714,26473,5455,72642
California,May,2010,19464,20997,0,40461
California,May,2011,22849,22801,0,45650
California,May,2012,27699,27093,72,54864
California,May,2013,31638,37157,71,68866
California,May,2014,38192,26630,3879,68701
California,May,2015,36049,25174,3848,65071
California,May,2016,38301,28723,6124,73148
California,May,2017,42442,24495,2760,69697
California,May,2018,34433,24797,3995,63225
California,May,2019,36314,24718,4700,65732
California,May,2020,50811,28550,6499,85860
California,May,2021,40160,25824,5576,71560
California,May,2022,37659,23729,5143,66531
California,May,2023,34421,21695,4841,60957
California,Nov,2009,16571,22677,0,39248
California,Nov,2010,18478,24984,0,43462
California,Nov,2011,23885,30091,49,54025
California,Nov,2012,35855,49929,74,85858
California,Nov,2013,31163,43714,84,74961
California,Nov,2014,43779,34964,4087,82830
California,Nov,2015,41181,35007,4559,80747
California,Nov,2016,56932,82554,30133,169619
California,Nov,2017,44710,35910,4241,84861
California,Nov,2018,36997,30913,3606,71516
California,Nov,2019,34345,25063,3564,62972
California,Nov,2020,56793,37256,7391,101440
California,Nov,2021,40966,29795,5177,75938
California,Nov,2022,37386,25634,4888,67908
California,Oct,2009,17537,19713,0,37250
California,Oct,2010,21351,22352,0,43703
California,Oct,2011,26693,28249,44,54986
California,Oct,2012,28860,30305,54,59219
California,Oct,2013,30693,37814,132,68639
California,Oct,2014,42829,30607,3536,76972
California,Oct,2015,37977,26151,3912,68040
California,Oct,2016,45785,54333,19226,119344
California,Oct,2017,39879,25749,3646,69274
California,Oct,2018,32567,23213,2738,58518
California,Oct,2019,32128,23005,4198,59331
California,Oct,2020,65376,40286,8319,113981
California,Oct,2021,40185,28159,5364,73708
California,Oct,2022,36991,22350,4451,63792
California,Sep,2009,15805,19228,0,35033
California,Sep,2010,18221,20434,0,38655
California,Sep,2011,22197,23657,39,45893
California,Sep,2012,26752,29344,52,56148
California,Sep,2013,27422,39102,75,66599
California,Sep,2014,37720,28503,3278,69501
California,Sep,2015,31897,24471,3429,59797
California,Sep,2016,39213,43015,13548,95776
California,Sep,2017,37165,24581,2984,64730
California,Sep,2018,29772,23788,2977,56537
California,Sep,2019,30776,22726,3524,57026
California,Sep,2020,61258,36638,7815,105711
California,Sep,2021,37842,27880,6190,71912
California,Sep,2022,34417,22375,4527,61319
California,Sep,2023,33792,20548,4295,58635
Florida,Apr,2010,26817,12952,0,39769
Florida,Apr,2011,30697,14985,0,45682
Florida,Apr,2012,34847,18257,703,53807
Florida,Apr,2013,41943,25404,2086,69433
Florida,Apr,2014,37470,19213,1728,58411
Florida,Apr,2015,40786,18180,1996,60962
Florida,Apr,2016,48697,19716,2788,71201
Florida,Apr,2017,52889,19489,3290,75668
Florida,Apr,2018,50172,18650,4446,73268
Florida,Apr,2019,48329,15125,3652,67106
Florida,Apr,2020,84431,26731,4897,116059
Florida,Apr,2021,79583,30218,6345,116146
Florida,Apr,2022,65359,22430,4912,92701
Florida,Apr,2023,69152,24519,4616,98287
Florida,Aug,2009,24043,13398,0,37441
Florida,Aug,2010,25610,13532,0,39142
Florida,Aug,2011,29668,15927,0,45595
Florida,Aug,2012,37184,20301,1162,58647
Florida,Aug,2013,35828,20307,1409,57544
Florida,Aug,2014,37260,19794,2009,59063
Florida,Aug,2015,42171,20307,2373,64851
Florida,Aug,2016,49867,23359,3572,76798
Florida,Aug,2017,46682,21717,2847,71246
Florida,Aug,2018,44227,15734,3176,63137
Florida,Aug,2019,54215,18910,4711,77836
Florida,Aug,2020,85345,30914,6509,122768
Florida,Aug,2021,61168,24363,5238,90769
Florida,Aug,2022,60229,22654,5518,88401
Florida,Aug,2023,55034,19438,5008,79480
Florida,Dec,2009,29581,24460,0,54041
Florida,Dec,2010,34196,27204,0,61400
Florida,Dec,2011,40463,31791,0,72254
Florida,Dec,2012,65872,59904,2549,128325
Florida,Dec,2013,44668,38782,1742,85192
Florida,Dec,2014,50412,37098,2500,90010
Florida,Dec,2015,86940,45769,4165,136874
Florida,Dec,2016,69842,39880,3488,113210
Florida,Dec,2017,68075,37127,4067,109269
Florida,Dec,2018,60210,30598,4131,94939
Florida,Dec,2019,67435,31580,4458,103473
Florida,Dec,2020,81564,40115,5594,127273
Florida,Dec,2021,77064,36710,5904,119678
Florida,Dec,2022,74886,35416,5826,116128
Florida,Feb,2010,30890,16415,0,47305
Florida,Feb,2011,37890,18121,0,56011
Florida,Feb,2012,43744,22852,747,67343
Florida,Feb,2013,56967,34711,1948,93626
Florida,Feb,2014,46802,25174,1614,73590
Florida,Feb,2015,52791,24827,2303,79921
Florida,Feb,2016,62770,25228,3069,91067
Florida,Feb,2017,59201,23479,2928,85608
Florida,Feb,2018,57435,26441,4590,88466
Florida,Feb,2019,51711,17833,3649,73193
Florida,Feb,2020,59653,20306,3748,83707
Florida,Feb,2021,66307,26720,5116,98143
Florida,Feb,2022,61461,23989,4261,89711
Florida,Feb,2023,60511,22852,4587,87950
Florida,Jan,2010,27038,15924,0,42962
Florida,Jan,2011,32684,16731,0,49415
Florida,Jan,2012,34951,18761,587,54299
Florida,Jan,2013,68294,41844,2047,112185
Florida,Jan,2014,37372,22370,1671,61413
Florida,Jan,2015,43909,21939,2433,68281
Florida,Jan,2016,62085,26356,3480,91921
Florida,Jan,2017,51599,21867,3129,76595
Florida,Jan,2018,48377,20690,3299,72366
Florida,Jan,2019,47372,18749,3651,69772
Florida,Jan,2020,54985,19973,3957,78915
Florida,Jan,2021,97406,40173,6686,144265
Florida,Jan,2022,57833,23109,4678,85620
Florida,Jan,2023,58648,22950,4883,86481
Florida,Jul,2009,23694,12349,0,36043
Florida,Jul,2010,25729,12007,0,37736
Florida,Jul,2011,27240,13412,0,40652
Florida,Jul,2012,34543,17864,926,53333
Florida,Jul,2013,34204,18664,1334,54202
Florida,Jul,2014,33878,17356,1737,52971
Florida,Jul,2015,42570,18069,2133,62772
Florida,Jul,2016,57902,28000,4504,90406
Florida,Jul,2017,47430,18941,2975,69346
Florida,Jul,2018,42524,13468,3215,59207
Florida,Jul,2019,43914,13570,3307,60791
Florida,Jul,2020,106745,33102,7751,147598
Florida,Jul,2021,62995,22918,5349,91262
Florida,Jul,2022,61996,21087,5289,88372
Florida,Jul,2023,59086,18577,4796,82459
Florida,Jun,2009,23275,12448,0,35723
Florida,Jun,2010,24424,11565,0,35989
Florida,Jun,2011,27744,13091,0,40835
Florida,Jun,2012,33679,17828,725,52232
Florida,Jun,2013,33559,19343,1393,54295
Florida,Jun,2014,33636,17047,1569,52252
Florida,Jun,2015,39592,17115,1989,58696
Florida,Jun,2016,55934,29501,5096,90531
Florida,Jun,2017,52114,19380,3260,74754
Florida,Jun,2018,44821,14764,3586,63171
Florida,Jun,2019,44378,13576,3642,61596
Florida,Jun,2020,133285,39111,7341,179737
Florida,Jun,2021,65835,23329,5551,94715
Florida,Jun,2022,70236,26816,6465,103517
Florida,Jun,2023,58766,20981,4863,84610
Florida,Mar,2010,32241,16265,0,48506
Florida,Mar,2011,35962,17283,0,53245
Florida,Mar,2012,41823,21504,836,64163
Florida,Mar,2013,48586,31464,1998,82048
Florida,Mar,2014,42745,23125,1819,67689
Florida,Mar,2015,46739,22690,2279,71708
Florida,Mar,2016,54164,22000,2874,79038
Florida,Mar,2017,60787,23982,3609,88378
Florida,Mar,2018,64230,30487,6732,101449
Florida,Mar,2019,59615,19429,3869,82913
Florida,Mar,2020,117900,38365,5017,161282
Florida,Mar,2021,91131,33936,6429,131496
Florida,Mar,2022,71992,28469,5182,105643
Florida,Mar,2023,65213,25801,4828,95842
Florida,May,2010,25428,11640,0,37068
Florida,May,2011,27882,12952,0,40834
Florida,May,2012,33310,17547,800,51657
Florida,May,2013,35935,21373,1491,58799
Florida,May,2014,35254,17504,1756,54514
Florida,May,2015,39775,17145,1962,58882
Florida,May,2016,42845,17025,2625,62495
Florida,May,2017,49700,18476,3001,71177
Florida,May,2018,47755,15850,3723,67328
Florida,May,2019,45087,14214,3760,63061
Florida,May,2020,73691,22529,5156,101376
Florida,May,2021,65295,22922,4934,93151
Florida,May,2022,59519,20002,4408,83929
Florida,May,2023,61383,21861,4709,87953
Florida,Nov,2009,25427,17590,0,43017
Florida,Nov,2010,27691,19404,0,47095
Florida,Nov,2011,30827,23480,0,54307
Florida,Nov,2012,43550,37856,1653,83059
Florida,Nov,2013,37545,30492,1571,69608
Florida,Nov,2014,39126,30723,1974,71823
Florida,Nov,2015,50796,28981,2268,82045
Florida,Nov,2016,62351,35718,3676,101745
Florida,Nov,2017,61694,31631,3585,96910
Florida,Nov,2018,51850,23876,3502,79228
Florida,Nov,2019,54799,24497,3666,82962
Florida,Nov,2020,84366,40575,6090,131031
Florida,Nov,2021,65666,31575,4266,101507
Florida,Nov,2022,61475,28064,4766,94305
Florida,Oct,2009,25740,15529,0,41269
Florida,Oct,2010,26902,15965,0,42867
Florida,Oct,2011,29491,18379,0,47870
Florida,Oct,2012,35686,23640,1071,60397
Florida,Oct,2013,34006,23276,1372,58654
Florida,Oct,2014,38428,23668,1904,64000
Florida,Oct,2015,45304,22587,2456,70347
Florida,Oct,2016,50003,27010,3908,80921
Florida,Oct,2017,49568,24580,3958,78106
Florida,Oct,2018,40226,16671,2912,59809
Florida,Oct,2019,47504,19816,3830,71150
Florida,Oct,2020,83816,32346,5782,121944
Florida,Oct,2021,63090,26371,4562,94023
Florida,Oct,2022,56101,21525,4409,82035
Florida,Sep,2009,23346,13521,0,36867
Florida,Sep,2010,25405,13802,0,39207
Florida,Sep,2011,29341,16267,0,45608
Florida,Sep,2012,33996,20479,895,55370
Florida,Sep,2013,31866,20815,1440,54121
Florida,Sep,2014,37253,21661,1791,60705
Florida,Sep,2015,40647,20159,2615,63421
Florida,Sep,2016,45848,22439,3359,71646
Florida,Sep,2017,39199,17949,2319,59467
Florida,Sep,2018,38313,14646,2945,55904
Florida,Sep,2019,44565,18261,4154,66980
Florida,Sep,2020,76685,29317,5523,111525
Florida,Sep,2021,59728,25555,5125,90408
Florida,Sep,2022,52674,20389,4536,77599
Florida,Sep,2023,51223,20945,4528,76696
Illinois,Apr,2010,8557,8005,0,16562
Illinois,Apr,2011,11468,9467,0,20935
Illinois,Apr,2012,14524,11497,0,26021
Illinois,Apr,2013,18421,14842,0,33263
Illinois,Apr,2014,21131,11333,0,32464
Illinois,Apr,2015,19123,9918,0,29041
Illinois,Apr,2016,24894,11132,0,36026
Illinois,Apr,2017,25414,10416,0,35830
Illinois,Apr,2018,23977,10883,0,34860
Illinois,Apr,2019,21307,8748,0,30055
Illinois,Apr,2020,30500,11184,0,41684
Illinois,Apr,2021,30084,12523,0,42607
Illinois,Apr,2022,24064,10548,1178,35790
Illinois,Apr,2023,27184,11406,1364,39954
Illinois,Aug,2009,6978,9265,0,16243
Illinois,Aug,2010,8621,8960,0,17581
Illinois,Aug,2011,9947,10717,0,20664
Illinois,Aug,2012,12980,14054,0,27034
Illinois,Aug,2013,16360,12936,0,29296
Illinois,Aug,2014,16532,12191,0,28723
Illinois,Aug,2015,18088,11085,0,29173
Illinois,Aug,2016,60745,30602,0,91347
Illinois,Aug,2017,19807,11333,0,31140
Illinois,Aug,2018,17992,9858,0,27850
Illinois,Aug,2019,19105,9281,0,28386
Illinois,Aug,2020,28864,13330,0,42194
Illinois,Aug,2021,26981,12930,1456,41367
Illinois,Aug,2022,21278,10914,1214,33406
Illinois,Aug,2023,20241,10349,811,31401
Illinois,Dec,2009,9316,13652,0,22968
Illinois,Dec,2010,11217,14646,0,25863
Illinois,Dec,2011,15946,18596,0,34542
Illinois,Dec,2012,28548,28820,0,57368
Illinois,Dec,2013,23671,19326,0,42997
Illinois,Dec,2014,24857,19709,0,44566
Illinois,Dec,2015,37193,20864,0,58057
Illinois,Dec,2016,29658,17164,0,46822
Illinois,Dec,2017,27956,15126,0,43082
Illinois,Dec,2018,26943,15297,0,42240
Illinois,Dec,2019,24792,13258,0,38050
Illinois,Dec,2020,29133,16557,0,45690
Illinois,Dec,2021,29123,14315,1471,44909
Illinois,Dec,2022,30563,18733,2005,51301
Illinois,Feb,2010,9998,10190,0,20188
Illinois,Feb,2011,11644,10778,0,22422
Illinois,Feb,2012,17750,14271,0,32021
Illinois,Feb,2013,24175,18387,0,42562
Illinois,Feb,2014,23448,13449,0,36897
Illinois,Feb,2015,23614,13379,0,36993
Illinois,Feb,2016,30241,13543,0,43784
Illinois,Feb,2017,27418,12635,0,40053
Illinois,Feb,2018,25626,12938,0,38564
Illinois,Feb,2019,24870,11381,0,36251
Illinois,Feb,2020,22743,9761,0,32504
Illinois,Feb,2021,24290,11338,0,35628
Illinois,Feb,2022,23796,10762,1186,35744
Illinois,Feb,2023,27357,10907,1103,39367
Illinois,Jan,2010,8799,9303,0,18102
Illinois,Jan,2011,10486,9844,0,20330
Illinois,Jan,2012,13424,11581,0,25005
Illinois,Jan,2013,31185,22138,0,53323
Illinois,Jan,2014,20164,11190,0,31354
Illinois,Jan,2015,20682,12203,0,32885
Illinois,Jan,2016,32112,12869,0,44981
Illinois,Jan,2017,24594,11185,0,35779
Illinois,Jan,2018,21821,9850,0,31671
Illinois,Jan,2019,21587,10082,0,31669
Illinois,Jan,2020,22567,9588,0,32155
Illinois,Jan,2021,35848,17817,0,53665
Illinois,Jan,2022,22564,9950,1015,33529
Illinois,Jan,2023,28370,14140,1715,44225
Illinois,Jul,2009,6742,6733,0,13475
Illinois,Jul,2010,7950,6957,0,14907
Illinois,Jul,2011,8812,7396,0,16208
Illinois,Jul,2012,11401,9755,0,21156
Illinois,Jul,2013,15986,10383,0,26369
Illinois,Jul,2014,15798,9607,0,25405
Illinois,Jul,2015,18469,9243,0,27712
Illinois,Jul,2016,21421,11881,0,33302
Illinois,Jul,2017,18417,9895,0,28312
Illinois,Jul,2018,16840,7743,0,24583
Illinois,Jul,2019,15782,6889,0,22671
Illinois,Jul,2020,31853,12250,0,44103
Illinois,Jul,2021,38557,15385,1605,55547
Illinois,Jul,2022,20758,9843,1133,31734
Illinois,Jul,2023,19386,8274,767,28427
Illinois,Jun,2009,6907,7155,0,14062
Illinois,Jun,2010,7818,6701,1,14520
Illinois,Jun,2011,9059,7372,0,16431
Illinois,Jun,2012,11820,10114,0,21934
Illinois,Jun,2013,15062,10196,0,25258
Illinois,Jun,2014,15406,8740,0,24146
Illinois,Jun,2015,17666,8230,0,25896
Illinois,Jun,2016,22277,12787,0,35064
Illinois,Jun,2017,21394,9491,0,30885
Illinois,Jun,2018,17755,7827,0,25582
Illinois,Jun,2019,17041,7321,0,24362
Illinois,Jun,2020,49101,14913,0,64014
Illinois,Jun,2021,24191,9377,0,33568
Illinois,Jun,2022,21912,10229,1204,33345
Illinois,Jun,2023,19399,7913,761,28073
Illinois,Mar,2010,11425,11398,0,22823
Illinois,Mar,2011,14745,12428,0,27173
Illinois,Mar,2012,17725,14376,0,32101
Illinois,Mar,2013,23779,19564,0,43343
Illinois,Mar,2014,26637,15182,0,41819
Illinois,Mar,2015,17517,10329,0,27846
Illinois,Mar,2016,29052,12971,0,42023
Illinois,Mar,2017,30518,14411,0,44929
Illinois,Mar,2018,32326,17008,0,49334
Illinois,Mar,2019,29438,13143,0,42581
Illinois,Mar,2020,44112,17127,0,61239
Illinois,Mar,2021,35699,16114,0,51813
Illinois,Mar,2022,30013,14121,1649,45783
Illinois,Mar,2023,34238,14033,1661,49932
Illinois,May,2010,8304,7071,0,15375
Illinois,May,2011,9700,8132,0,17832
Illinois,May,2012,11987,9817,0,21804
Illinois,May,2013,16142,11591,0,27733
Illinois,May,2014,17848,9308,0,27156
Illinois,May,2015,19457,9346,0,28803
Illinois,May,2016,19264,8686,0,27950
Illinois,May,2017,22244,9252,0,31496
Illinois,May,2018,18631,8397,0,27028
Illinois,May,2019,17976,7587,0,25563
Illinois,May,2020,26854,9959,0,36813
Illinois,May,2021,25210,9855,0,35065
Illinois,May,2022,19865,8639,1031,29535
Illinois,May,2023,23805,11014,1103,35922
Illinois,Nov,2009,7925,12399,0,20324
Illinois,Nov,2010,9128,13938,0,23066
Illinois,Nov,2011,12039,16397,0,28436
Illinois,Nov,2012,16845,22364,0,39209
Illinois,Nov,2013,20356,18330,0,38686
Illinois,Nov,2014,19282,18280,0,37562
Illinois,Nov,2015,24412,17227,0,41639
Illinois,Nov,2016,28463,19005,0,47468
Illinois,Nov,2017,26122,16102,0,42224
Illinois,Nov,2018,22978,14038,0,37016
Illinois,Nov,2019,21597,12115,0,33712
Illinois,Nov,2020,29335,17557,0,46892
Illinois,Nov,2021,25791,14008,1552,41351
Illinois,Nov,2022,24875,14612,1564,41051
Illinois,Oct,2009,8321,11369,0,19690
Illinois,Oct,2010,8918,10462,0,19380
Illinois,Oct,2011,10417,12084,0,22501
Illinois,Oct,2012,13118,15029,0,28147
Illinois,Oct,2013,17090,14128,0,31218
Illinois,Oct,2014,17927,14023,0,31950
Illinois,Oct,2015,19306,12361,0,31667
Illinois,Oct,2016,33986,14739,0,48725
Illinois,Oct,2017,20093,12503,0,32596
Illinois,Oct,2018,17916,10755,0,28671
Illinois,Oct,2019,17482,10040,0,27522
Illinois,Oct,2020,28277,14905,0,43182
Illinois,Oct,2021,24172,12375,1311,37858
Illinois,Oct,2022,21387,10840,1091,33318
Illinois,Sep,2009,6722,9425,0,16147
Illinois,Sep,2010,8469,9115,0,17584
Illinois,Sep,2011,9915,10724,0,20639
Illinois,Sep,2012,11788,12727,0,24515
Illinois,Sep,2013,14147,12860,0,27007
Illinois,Sep,2014,16060,12191,0,28251
Illinois,Sep,2015,17451,12693,0,30144
Illinois,Sep,2016,20298,11876,0,32174
Illinois,Sep,2017,18290,10201,0,28491
Illinois,Sep,2018,16749,9393,0,26142
Illinois,Sep,2019,17639,9512,0,27151
Illinois,Sep,2020,27645,13848,0,41493
Illinois,Sep,2021,22461,11566,1287,35314
Illinois,Sep,2022,21772,10505,1175,33452
Illinois,Sep,2023,19675,10357,786,30818
Indiana,Apr,2010,8149,7473,227,15849
Indiana,Apr,2011,10938,9339,285,20562
Indiana,Apr,2012,13520,10411,405,24336
Indiana,Apr,2013,17150,14005,787,31942
Indiana,Apr,2014,16956,11235,801,28992
Indiana,Apr,2015,16372,10732,823,27927
Indiana,Apr,2016,20756,12137,1079,33972
Indiana,Apr,2017,21454,11390,1158,34002
Indiana,Apr,2018,19405,11491,1758,32654
Indiana,Apr,2019,18528,9718,1493,29739
Indiana,Apr,2020,29904,14843,2332,47079
Indiana,Apr,2021,29792,16385,2400,48577
Indiana,Apr,2022,24086,13122,1933,39141
Indiana,Apr,2023,20732,12656,1670,35058
Indiana,Aug,2009,7900,8544,201,16645
Indiana,Aug,2010,9467,8859,218,18544
Indiana,Aug,2011,9898,9924,338,20160
Indiana,Aug,2012,13991,12638,593,27222
Indiana,Aug,2013,14264,12775,597,27636
Indiana,Aug,2014,15459,12168,662,28289
Indiana,Aug,2015,16546,11880,894,29320
Indiana,Aug,2016,18906,13606,1238,33750
Indiana,Aug,2017,17271,11844,1132,30247
Indiana,Aug,2018,15764,10339,1252,27355
Indiana,Aug,2019,19883,11389,1756,33028
Indiana,Aug,2020,28843,16235,2226,47304
Indiana,Aug,2021,21769,13831,1786,37386
Indiana,Aug,2022,23746,12311,1717,37774
Indiana,Aug,2023,16646,10978,1549,29173
Indiana,Dec,2009,9904,14739,218,24861
Indiana,Dec,2010,11672,15692,236,27600
Indiana,Dec,2011,16616,19842,435,36893
Indiana,Dec,2012,28474,31940,1357,61771
Indiana,Dec,2013,20168,21557,841,42566
Indiana,Dec,2014,23399,21186,1044,45629
Indiana,Dec,2015,44150,26105,2370,72625
Indiana,Dec,2016,30248,21688,1546,53482
Indiana,Dec,2017,26719,19906,1839,48464
Indiana,Dec,2018,24824,18824,2088,45736
Indiana,Dec,2019,26770,18746,2075,47591
Indiana,Dec,2020,30336,21852,2192,54380
Indiana,Dec,2021,29183,20059,2676,51918
Indiana,Dec,2022,28936,18301,2244,49481
Indiana,Feb,2010,11285,9441,302,21028
Indiana,Feb,2011,13991,9923,284,24198
Indiana,Feb,2012,19808,14257,568,34633
Indiana,Feb,2013,26643,18179,865,45687
Indiana,Feb,2014,22970,14166,904,38040
Indiana,Feb,2015,24373,13650,1152,39175
Indiana,Feb,2016,32373,14947,1625,48945
Indiana,Feb,2017,27343,13221,1288,41852
Indiana,Feb,2018,24019,13516,2056,39591
Indiana,Feb,2019,21297,11157,1623,34077
Indiana,Feb,2020,25949,12739,1974,40662
Indiana,Feb,2021,25161,14378,2063,41602
Indiana,Feb,2022,22916,13065,1803,37784
Indiana,Feb,2023,24114,12607,1765,38486
Indiana,Jan,2010,9948,8614,294,18856
Indiana,Jan,2011,11783,8704,359,20846
Indiana,Jan,2012,14224,10574,511,25309
Indiana,Jan,2013,30334,20505,1121,51960
Indiana,Jan,2014,14854,10418,908,26180
Indiana,Jan,2015,18433,11935,1081,31449
Indiana,Jan,2016,29653,14356,1871,45880
Indiana,Jan,2017,21284,11456,1261,34001
Indiana,Jan,2018,17558,10258,1456,29272
Indiana,Jan,2019,17265,10423,1738,29426
Indiana,Jan,2020,22340,12461,2166,36967
Indiana,Jan,2021,37237,22732,3005,62974
Indiana,Jan,2022,21402,12343,2205,35950
Indiana,Jan,2023,22825,12560,1912,37297
Indiana,Jul,2009,6953,6249,203,13405
Indiana,Jul,2010,7672,6279,150,14101
Indiana,Jul,2011,8622,6938,240,15800
Indiana,Jul,2012,11809,9380,387,21576
Indiana,Jul,2013,12316,9385,481,22182
Indiana,Jul,2014,13475,9126,555,23156
Indiana,Jul,2015,15416,8954,758,25128
Indiana,Jul,2016,19508,12191,1600,33299
Indiana,Jul,2017,15385,9995,950,26330
Indiana,Jul,2018,13914,7825,1101,22840
Indiana,Jul,2019,13982,7568,1225,22775
Indiana,Jul,2020,32970,15066,2395,50431
Indiana,Jul,2021,21274,11190,1668,34132
Indiana,Jul,2022,25699,10652,1683,38034
Indiana,Jul,2023,16217,9321,1450,26988
Indiana,Jun,2009,6842,6285,15,13142
Indiana,Jun,2010,7950,6307,228,14485
Indiana,Jun,2011,8876,6861,251,15988
Indiana,Jun,2012,12193,9656,432,22281
Indiana,Jun,2013,12447,9845,628,22920
Indiana,Jun,2014,13069,8702,530,22301
Indiana,Jun,2015,14845,8455,742,24042
Indiana,Jun,2016,18307,11949,1831,32087
Indiana,Jun,2017,18351,9706,1093,29150
Indiana,Jun,2018,15459,8455,1214,25128
Indiana,Jun,2019,15272,7963,1368,24603
Indiana,Jun,2020,40492,16560,2561,59613
Indiana,Jun,2021,21193,10780,1592,33565
Indiana,Jun,2022,22310,11461,2008,35779
Indiana,Jun,2023,17712,9939,1512,29163
Indiana,Mar,2010,12071,10378,386,22835
Indiana,Mar,2011,15597,11489,468,27554
Indiana,Mar,2012,18763,13250,672,32685
Indiana,Mar,2013,24239,18379,1055,43673
Indiana,Mar,2014,23024,15040,1085,39149
Indiana,Mar,2015,22176,13898,1201,37275
Indiana,Mar,2016,27883,13485,1472,42840
Indiana,Mar,2017,28593,14363,1575,44531
Indiana,Mar,2018,28224,16982,2950,48156
Indiana,Mar,2019,26630,13737,2005,42372
Indiana,Mar,2020,45695,22724,2613,71032
Indiana,Mar,2021,36403,19692,2543,58638
Indiana,Mar,2022,30469,16666,2365,49500
Indiana,Mar,2023,26541,14706,2078,43325
Indiana,May,2010,7761,6257,216,14234
Indiana,May,2011,8658,7073,241,15972
Indiana,May,2012,11816,9152,380,21348
Indiana,May,2013,13497,10404,682,24583
Indiana,May,2014,15395,9454,677,25526
Indiana,May,2015,15952,8778,744,25474
Indiana,May,2016,16842,9264,965,27071
Indiana,May,2017,18110,9483,1060,28653
Indiana,May,2018,15856,8256,1296,25408
Indiana,May,2019,15062,8146,1431,24639
Indiana,May,2020,30133,14420,2221,46774
Indiana,May,2021,22724,11629,1660,36013
Indiana,May,2022,19617,9957,1372,30946
Indiana,May,2023,18327,10110,1464,29901
Indiana,Nov,2009,7883,14084,191,22158
Indiana,Nov,2010,8862,14956,185,24003
Indiana,Nov,2011,11350,17074,324,28748
Indiana,Nov,2012,17383,24331,899,42613
Indiana,Nov,2013,17093,21064,744,38901
Indiana,Nov,2014,16681,20381,824,37886
Indiana,Nov,2015,25519,20227,1113,46859
Indiana,Nov,2016,25246,23336,1521,50103
Indiana,Nov,2017,22558,20820,1772,45150
Indiana,Nov,2018,20522,18723,1533,40778
Indiana,Nov,2019,21903,17950,1776,41629
Indiana,Nov,2020,29416,24425,2231,56072
Indiana,Nov,2021,23950,19182,1769,44901
Indiana,Nov,2022,23698,18044,1642,43384
Indiana,Oct,2009,8784,11917,253,20954
Indiana,Oct,2010,9477,11402,240,21119
Indiana,Oct,2011,10498,12206,354,23058
Indiana,Oct,2012,14083,15844,690,30617
Indiana,Oct,2013,14671,14624,620,29915
Indiana,Oct,2014,16054,15005,733,31792
Indiana,Oct,2015,18633,13859,1055,33547
Indiana,Oct,2016,21058,16857,1725,39640
Indiana,Oct,2017,15966,13202,1450,30618
Indiana,Oct,2018,15032,12352,1151,28535
Indiana,Oct,2019,16204,12595,1528,30327
Indiana,Oct,2020,27979,18181,2216,48376
Indiana,Oct,2021,21585,15646,1904,39135
Indiana,Oct,2022,20226,12643,1434,34303
Indiana,Sep,2009,6860,8705,170,15735
Indiana,Sep,2010,8301,8792,167,17260
Indiana,Sep,2011,9423,10639,281,20343
Indiana,Sep,2012,12916,12873,509,26298
Indiana,Sep,2013,12956,12954,576,26486
Indiana,Sep,2014,13876,12326,647,26849
Indiana,Sep,2015,16754,11905,965,29624
Indiana,Sep,2016,17402,13402,1291,32095
Indiana,Sep,2017,16093,11332,1123,28548
Indiana,Sep,2018,13687,10201,1068,24956
Indiana,Sep,2019,15291,10734,1680,27705
Indiana,Sep,2020,26530,15978,1955,44463
Indiana,Sep,2021,20859,14814,1857,37530
Indiana,Sep,2022,21991,12729,1559,36279
Indiana,Sep,2023,16104,11963,1480,29547
Missouri,Apr,2010,11550,9599,199,21348
Missouri,Apr,2011,14435,11840,298,26573
Missouri,Apr,2012,15210,12050,394,27654
Missouri,Apr,2013,19776,16405,715,36896
Missouri,Apr,2014,16394,13060,697,30151
Missouri,Apr,2015,17715,12531,812,31058
Missouri,Apr,2016,19787,12754,970,33511
Missouri,Apr,2017,20328,14124,1233,35685
Missouri,Apr,2018,18537,13868,1791,34196
Missouri,Apr,2019,15972,12020,1478,29470
Missouri,Apr,2020,32009,17962,2470,52441
Missouri,Apr,2021,26961,18774,2755,48490
Missouri,Apr,2022,21431,16216,2080,39727
Missouri,Apr,2023,17821,13932,1600,33353
Missouri,Aug,2009,11415,11302,196,22913
Missouri,Aug,2010,11357,10602,211,22170
Missouri,Aug,2011,12579,11701,284,24564
Missouri,Aug,2012,16799,15229,546,32574
Missouri,Aug,2013,16625,14656,505,31786
Missouri,Aug,2014,17329,14418,677,32424
Missouri,Aug,2015,16501,13231,941,30673
Missouri,Aug,2016,18394,15365,1418,35177
Missouri,Aug,2017,17369,13918,1227,32514
Missouri,Aug,2018,16706,13657,1371,31734
Missouri,Aug,2019,18605,14755,1809,35169
Missouri,Aug,2020,26351,17461,2343,46155
Missouri,Aug,2021,19196,15047,1815,36058
Missouri,Aug,2022,18675,14329,1948,34952
Missouri,Aug,2023,16188,13538,1729,31455
Missouri,Dec,2009,14525,19444,274,34243
Missouri,Dec,2010,15736,19623,270,35629
Missouri,Dec,2011,19205,23887,486,43578
Missouri,Dec,2012,35516,36872,1448,73836
Missouri,Dec,2013,20002,24195,813,45010
Missouri,Dec,2014,27713,25507,1224,54444
Missouri,Dec,2015,43300,30091,2272,75663
Missouri,Dec,2016,29770,27013,1507,58290
Missouri,Dec,2017,28561,27288,2007,57856
Missouri,Dec,2018,24730,23584,2058,50372
Missouri,Dec,2019,26084,22222,2346,50652
Missouri,Dec,2020,29358,26348,2683,58389
Missouri,Dec,2021,28648,24331,2906,55885
Missouri,Dec,2022,27213,23525,2645,53383
Missouri,Feb,2010,16080,12779,283,29142
Missouri,Feb,2011,16363,12602,358,29323
Missouri,Feb,2012,23012,16630,597,40239
Missouri,Feb,2013,30172,21984,830,52986
Missouri,Feb,2014,21678,16291,825,38794
Missouri,Feb,2015,26048,15858,1120,43026
Missouri,Feb,2016,30802,16707,1404,48913
Missouri,Feb,2017,26726,16012,1393,44131
Missouri,Feb,2018,23601,17167,1927,42695
Missouri,Feb,2019,19884,13773,1688,35345
Missouri,Feb,2020,23420,14384,1965,39769
Missouri,Feb,2021,21819,16008,2157,39984
Missouri,Feb,2022,21511,15343,2145,38999
Missouri,Feb,2023,21445,15486,1910,38841
Missouri,Jan,2010,12126,10374,270,22770
Missouri,Jan,2011,14075,11247,270,25592
Missouri,Jan,2012,15948,12991,442,29381
Missouri,Jan,2013,36400,24147,1077,61624
Missouri,Jan,2014,16170,12823,840,29833
Missouri,Jan,2015,21243,13943,1185,36371
Missouri,Jan,2016,28980,15693,1942,46615
Missouri,Jan,2017,20123,13512,1257,34892
Missouri,Jan,2018,17240,12403,1364,31007
Missouri,Jan,2019,16244,12657,1805,30706
Missouri,Jan,2020,20436,13149,2065,35650
Missouri,Jan,2021,34178,24308,3423,61909
Missouri,Jan,2022,18427,13713,2258,34398
Missouri,Jan,2023,19831,14724,2133,36688
Missouri,Jul,2009,10460,8303,168,18931
Missouri,Jul,2010,10845,7545,208,18598
Missouri,Jul,2011,11070,8276,289,19635
Missouri,Jul,2012,13903,10796,431,25130
Missouri,Jul,2013,14710,10174,446,25330
Missouri,Jul,2014,12678,9729,570,22977
Missouri,Jul,2015,16736,10260,935,27931
Missouri,Jul,2016,20791,13575,1698,36064
Missouri,Jul,2017,16151,11098,1013,28262
Missouri,Jul,2018,14330,10470,1187,25987
Missouri,Jul,2019,14131,10224,1249,25604
Missouri,Jul,2020,31991,17146,2753,51890
Missouri,Jul,2021,20008,13122,1936,35066
Missouri,Jul,2022,19786,12698,2091,34575
Missouri,Jul,2023,15409,10686,1687,27782
Missouri,Jun,2009,10835,7823,9,18667
Missouri,Jun,2010,11293,7782,200,19275
Missouri,Jun,2011,11684,7896,258,19838
Missouri,Jun,2012,14002,10593,390,24985
Missouri,Jun,2013,14577,10444,465,25486
Missouri,Jun,2014,13225,9673,584,23482
Missouri,Jun,2015,16285,9733,949,26967
Missouri,Jun,2016,18770,13295,1813,33878
Missouri,Jun,2017,19459,11470,1200,32129
Missouri,Jun,2018,15679,10488,1421,27588
Missouri,Jun,2019,14970,10263,1443,26676
Missouri,Jun,2020,38153,17472,2786,58411
Missouri,Jun,2021,20234,12466,1890,34590
Missouri,Jun,2022,20382,13146,2377,35905
Missouri,Jun,2023,16411,11306,1587,29304
Missouri,Mar,2010,15617,12253,341,28211
Missouri,Mar,2011,18610,13979,393,32982
Missouri,Mar,2012,20609,15430,617,36656
Missouri,Mar,2013,26501,21600,945,49046
Missouri,Mar,2014,20739,15823,876,37438
Missouri,Mar,2015,23164,15636,1086,39886
Missouri,Mar,2016,27030,15359,1257,43646
Missouri,Mar,2017,27625,17931,1537,47093
Missouri,Mar,2018,27559,21245,3069,51873
Missouri,Mar,2019,23939,17749,2160,43848
Missouri,Mar,2020,41905,22607,2610,67122
Missouri,Mar,2021,36589,24048,3145,63782
Missouri,Mar,2022,27618,20103,2688,50409
Missouri,Mar,2023,23855,17769,2084,43708
Missouri,May,2010,10851,7698,194,18743
Missouri,May,2011,12186,8850,254,21290
Missouri,May,2012,13959,10395,361,24715
Missouri,May,2013,16990,12515,625,30130
Missouri,May,2014,14385,9810,590,24785
Missouri,May,2015,17111,10085,799,27995
Missouri,May,2016,16909,10162,966,28037
Missouri,May,2017,18290,11468,1067,30825
Missouri,May,2018,15576,10536,1334,27446
Missouri,May,2019,15869,10448,1452,27769
Missouri,May,2020,31302,16484,2308,50094
Missouri,May,2021,22598,14505,1992,39095
Missouri,May,2022,18363,11898,1790,32051
Missouri,May,2023,17012,11619,1610,30241
Missouri,Nov,2009,10663,16145,216,27024
Missouri,Nov,2010,11684,17214,240,29138
Missouri,Nov,2011,12697,20547,315,33559
Missouri,Nov,2012,19943,27029,827,47799
Missouri,Nov,2013,15610,23535,617,39762
Missouri,Nov,2014,23419,26565,841,50825
Missouri,Nov,2015,21135,22852,1004,44991
Missouri,Nov,2016,23719,26338,1473,51530
Missouri,Nov,2017,23099,26209,1428,50736
Missouri,Nov,2018,19158,21908,1551,42617
Missouri,Nov,2019,21090,21032,1659,43781
Missouri,Nov,2020,27413,27727,2932,58072
Missouri,Nov,2021,22588,22189,1965,46742
Missouri,Nov,2022,21737,21503,1800,45040
Missouri,Oct,2009,12308,16487,198,28993
Missouri,Oct,2010,11534,15056,215,26805
Missouri,Oct,2011,12526,16426,311,29263
Missouri,Oct,2012,15628,20116,634,36378
Missouri,Oct,2013,15300,18695,517,34512
Missouri,Oct,2014,18128,20255,834,39217
Missouri,Oct,2015,18686,18848,1044,38578
Missouri,Oct,2016,21994,20919,1633,44546
Missouri,Oct,2017,17985,19508,1464,38957
Missouri,Oct,2018,15963,17163,1320,34446
Missouri,Oct,2019,16633,18732,1646,37011
Missouri,Oct,2020,25340,22636,2386,50362
Missouri,Oct,2021,20788,19311,2012,42111
Missouri,Oct,2022,18211,17451,1639,37301
Missouri,Sep,2009,10959,11621,191,22771
Missouri,Sep,2010,11250,11432,194,22876
Missouri,Sep,2011,12359,12894,330,25583
Missouri,Sep,2012,15282,15154,498,30934
Missouri,Sep,2013,14101,14257,536,28894
Missouri,Sep,2014,14837,14838,646,30321
Missouri,Sep,2015,16053,13650,862,30565
Missouri,Sep,2016,17808,15528,1323,34659
Missouri,Sep,2017,16993,14395,1050,32438
Missouri,Sep,2018,15226,12816,1270,29312
Missouri,Sep,2019,15032,13663,1559,30254
Missouri,Sep,2020,24614,17708,2216,44538
Missouri,Sep,2021,19206,16266,2007,37479
Missouri,Sep,2022,18416,15044,1658,35118
Missouri,Sep,2023,15275,14310,1627,31212
Ohio,Apr,2010,17333,11342,329,29004
Ohio,Apr,2011,21622,14325,472,36419
Ohio,Apr,2012,25352,15717,610,41679
Ohio,Apr,2013,31627,21579,1266,54472
Ohio,Apr,2014,26196,18183,1228,45607
Ohio,Apr,2015,26841,16124,1256,44221
Ohio,Apr,2016,32959,17664,1618,52241
Ohio,Apr,2017,31417,16030,1580,49027
Ohio,Apr,2018,25111,15459,1971,42541
Ohio,Apr,2019,22541,11994,2104,36639
Ohio,Apr,2020,37486,18560,2295,58341
Ohio,Apr,2021,34710,18884,1928,55522
Ohio,Apr,2022,27592,15402,1585,44579
Ohio,Apr,2023,23293,15181,1549,40023
Ohio,Aug,2009,12895,11300,367,24562
Ohio,Aug,2010,14235,11330,380,25945
Ohio,Aug,2011,17325,13410,345,31080
Ohio,Aug,2012,23175,16601,763,40539
Ohio,Aug,2013,21681,16535,723,38939
Ohio,Aug,2014,20742,16787,939,38468
Ohio,Aug,2015,23147,15795,1132,40074
Ohio,Aug,2016,26261,17526,1626,45413
Ohio,Aug,2017,21432,14447,1242,37121
Ohio,Aug,2018,18482,12449,1181,32112
Ohio,Aug,2019,22222,12658,1901,36781
Ohio,Aug,2020,37224,19937,2099,59260
Ohio,Aug,2021,21249,15507,1483,38239
Ohio,Aug,2022,23314,13691,1581,38586
Ohio,Aug,2023,18488,12634,1424,32546
Ohio,Dec,2009,17880,20595,320,38795
Ohio,Dec,2010,21429,22061,375,43865
Ohio,Dec,2011,29717,28886,594,59197
Ohio,Dec,2012,48667,47197,2002,97866
Ohio,Dec,2013,31976,30852,1252,64080
Ohio,Dec,2014,35658,30752,1609,68019
Ohio,Dec,2015,60280,38256,2942,101478
Ohio,Dec,2016,40996,29641,1877,72514
Ohio,Dec,2017,34374,27651,1773,63798
Ohio,Dec,2018,30746,25012,1863,57621
Ohio,Dec,2019,31054,23312,2223,56589
Ohio,Dec,2020,33723,27057,1804,62584
Ohio,Dec,2021,32597,24233,2522,59352
Ohio,Dec,2022,33116,21775,1912,56803
Ohio,Feb,2010,18528,12089,408,31025
Ohio,Feb,2011,24197,14456,579,39232
Ohio,Feb,2012,35526,19840,770,56136
Ohio,Feb,2013,45622,26931,1624,74177
Ohio,Feb,2014,32864,19732,1373,53969
Ohio,Feb,2015,34137,18836,1682,54655
Ohio,Feb,2016,45459,20745,2196,68400
Ohio,Feb,2017,36244,18068,2030,56342
Ohio,Feb,2018,30691,19698,2193,52582
Ohio,Feb,2019,25652,13985,1635,41272
Ohio,Feb,2020,29360,14843,2448,46651
Ohio,Feb,2021,28134,16727,1730,46591
Ohio,Feb,2022,24245,14659,1633,40537
Ohio,Feb,2023,28191,15172,1813,45176
Ohio,Jan,2010,16178,11272,435,27885
Ohio,Jan,2011,18305,11163,417,29885
Ohio,Jan,2012,22307,13742,532,36581
Ohio,Jan,2013,49243,29034,1625,79902
Ohio,Jan,2014,21851,14893,1266,38010
Ohio,Jan,2015,26268,16186,1678,44132
Ohio,Jan,2016,38028,18613,2460,59101
Ohio,Jan,2017,27124,15070,1696,43890
Ohio,Jan,2018,21340,12521,1704,35565
Ohio,Jan,2019,19573,12290,1648,33511
Ohio,Jan,2020,24218,13069,2066,39353
Ohio,Jan,2021,45379,26775,2405,74559
Ohio,Jan,2022,21582,13064,1956,36602
Ohio,Jan,2023,24938,13130,1563,39631
Ohio,Jul,2009,12794,10179,368,23341
Ohio,Jul,2010,14141,9700,291,24132
Ohio,Jul,2011,15404,10937,415,26756
Ohio,Jul,2012,20677,13904,581,35162
Ohio,Jul,2013,21099,14667,772,36538
Ohio,Jul,2014,19770,14202,1000,34972
Ohio,Jul,2015,23344,13252,1224,37820
Ohio,Jul,2016,27876,17720,2166,47762
Ohio,Jul,2017,20990,14131,1227,36348
Ohio,Jul,2018,16942,10255,1102,28299
Ohio,Jul,2019,15931,9342,1203,26476
Ohio,Jul,2020,43645,18865,2325,64835
Ohio,Jul,2021,22251,13383,1546,37180
Ohio,Jul,2022,25780,12538,1537,39855
Ohio,Jul,2023,18760,11771,1472,32003
Ohio,Jun,2009,12529,10182,14,22725
Ohio,Jun,2010,12808,8904,259,21971
Ohio,Jun,2011,15226,9991,370,25587
Ohio,Jun,2012,20125,14019,462,34606
Ohio,Jun,2013,20896,14770,716,36382
Ohio,Jun,2014,18471,13177,947,32595
Ohio,Jun,2015,22545,13307,1118,36970
Ohio,Jun,2016,24397,17086,2294,43777
Ohio,Jun,2017,23703,13536,1324,38563
Ohio,Jun,2018,17338,10649,1163,29150
Ohio,Jun,2019,17949,9885,1659,29493
Ohio,Jun,2020,54811,21686,2452,78949
Ohio,Jun,2021,23534,12963,1335,37832
Ohio,Jun,2022,29208,13273,1636,44117
Ohio,Jun,2023,18799,11658,1258,31715
Ohio,Mar,2010,21508,14073,456,36037
Ohio,Mar,2011,26107,16404,623,43134
Ohio,Mar,2012,33749,19245,886,53880
Ohio,Mar,2013,42641,27725,1614,71980
Ohio,Mar,2014,32656,21426,1535,55617
Ohio,Mar,2015,32293,20400,1797,54490
Ohio,Mar,2016,40331,19408,2179,61918
Ohio,Mar,2017,37474,19925,2384,59783
Ohio,Mar,2018,36314,24477,3483,64274
Ohio,Mar,2019,31090,17313,2208,50611
Ohio,Mar,2020,63707,28817,2793,95317
Ohio,Mar,2021,42665,23081,2175,67921
Ohio,Mar,2022,35780,18954,2044,56778
Ohio,Mar,2023,29772,17706,2057,49535
Ohio,May,2010,14214,9410,332,23956
Ohio,May,2011,17056,10842,359,28257
Ohio,May,2012,20446,13211,551,34208
Ohio,May,2013,23364,15596,849,39809
Ohio,May,2014,21891,14553,1013,37457
Ohio,May,2015,22978,12473,1026,36477
Ohio,May,2016,26069,13219,1435,40723
Ohio,May,2017,25230,12924,1375,39529
Ohio,May,2018,18830,10891,1395,31116
Ohio,May,2019,17577,9758,1569,28904
Ohio,May,2020,37486,17996,2268,57750
Ohio,May,2021,26043,13075,1345,40463
Ohio,May,2022,22495,11534,1208,35237
Ohio,May,2023,20161,11643,1319,33123
Ohio,Nov,2009,15223,20759,314,36296
Ohio,Nov,2010,16886,22161,333,39380
Ohio,Nov,2011,21362,24640,436,46438
Ohio,Nov,2012,32230,36389,1108,69727
Ohio,Nov,2013,26725,29854,962,57541
Ohio,Nov,2014,26893,32001,1413,60307
Ohio,Nov,2015,34878,31817,1392,68087
Ohio,Nov,2016,37304,32312,1977,71593
Ohio,Nov,2017,30973,28808,1690,61471
Ohio,Nov,2018,25372,26274,1615,53261
Ohio,Nov,2019,25230,24933,2034,52197
Ohio,Nov,2020,37382,32959,2122,72463
Ohio,Nov,2021,26580,24593,1942,53115
Ohio,Nov,2022,28175,23760,1472,53407
Ohio,Oct,2009,15130,15489,327,30946
Ohio,Oct,2010,16955,14932,390,32277
Ohio,Oct,2011,19153,16836,430,36419
Ohio,Oct,2012,23729,21397,816,45942
Ohio,Oct,2013,23348,20561,847,44756
Ohio,Oct,2014,25552,22111,1495,49158
Ohio,Oct,2015,27354,20613,1347,49314
Ohio,Oct,2016,30593,21991,2592,55176
Ohio,Oct,2017,22833,18172,1593,42598
Ohio,Oct,2018,18401,15830,1139,35370
Ohio,Oct,2019,18896,16127,1706,36729
Ohio,Oct,2020,35332,23048,1962,60342
Ohio,Oct,2021,23158,18255,1983,43396
Ohio,Oct,2022,21257,15147,1196,37600
Ohio,Sep,2009,12947,12103,338,25388
Ohio,Sep,2010,14875,12466,296,27637
Ohio,Sep,2011,17864,14411,450,32725
Ohio,Sep,2012,22700,18049,649,41398
Ohio,Sep,2013,20526,18142,765,39433
Ohio,Sep,2014,20852,17783,912,39547
Ohio,Sep,2015,23309,16734,1383,41426
Ohio,Sep,2016,24297,18038,1573,43908
Ohio,Sep,2017,21085,14998,1202,37285
Ohio,Sep,2018,17460,13312,1110,31882
Ohio,Sep,2019,17083,13048,1534,31665
Ohio,Sep,2020,32432,19759,1717,53908
Ohio,Sep,2021,21142,16111,1695,38948
Ohio,Sep,2022,22226,14018,1282,37526
Ohio,Sep,2023,18621,14068,1400,34089
Pennsylvania,Apr,2010,1,49644,0,49645
Pennsylvania,Apr,2011,2,61720,0,61722
Pennsylvania,Apr,2012,29,71424,1,71454
Pennsylvania,Apr,2013,22,64416,339,64777
Pennsylvania,Apr,2014,44546,7942,0,52488
Pennsylvania,Apr,2015,45156,7908,0,53064
Pennsylvania,Apr,2016,51472,11628,15,63115
Pennsylvania,Apr,2017,48255,11877,97,60229
Pennsylvania,Apr,2018,47093,13434,38,60565
Pennsylvania,Apr,2019,42418,12300,32,54750
Pennsylvania,Apr,2020,54041,14778,40,68859
Pennsylvania,Apr,2021,62389,25486,39,87914
Pennsylvania,Apr,2022,49384,21978,59,71421
Pennsylvania,Apr,2023,43869,21576,47,65492
Pennsylvania,Aug,2009,0,44637,0,44637
Pennsylvania,Aug,2010,0,47082,0,47082
Pennsylvania,Aug,2011,6,54551,0,54557
Pennsylvania,Aug,2012,44,72106,10,72160
Pennsylvania,Aug,2013,29,52638,170,52837
Pennsylvania,Aug,2014,40384,8958,0,49342
Pennsylvania,Aug,2015,41542,7972,0,49514
Pennsylvania,Aug,2016,46155,11700,4,57859
Pennsylvania,Aug,2017,40628,13170,78,53876
Pennsylvania,Aug,2018,38142,11911,48,50101
Pennsylvania,Aug,2019,43559,13314,45,56918
Pennsylvania,Aug,2020,69325,24361,37,93723
Pennsylvania,Aug,2021,47491,21938,16,69445
Pennsylvania,Aug,2022,43173,19780,42,62995
Pennsylvania,Aug,2023,35397,18299,28,53724
Pennsylvania,Dec,2009,0,56138,0,56138
Pennsylvania,Dec,2010,0,63195,0,63195
Pennsylvania,Dec,2011,32,83662,2,83696
Pennsylvania,Dec,2012,78,105826,319,106223
Pennsylvania,Dec,2013,20,68271,252,68543
Pennsylvania,Dec,2014,61828,12737,0,74565
Pennsylvania,Dec,2015,90055,18758,0,108813
Pennsylvania,Dec,2016,64220,18688,40,82948
Pennsylvania,Dec,2017,57826,19809,59,77694
Pennsylvania,Dec,2018,54857,20732,18,75607
Pennsylvania,Dec,2019,53180,20278,32,73490
Pennsylvania,Dec,2020,62948,29262,41,92251
Pennsylvania,Dec,2021,57822,30165,28,88015
Pennsylvania,Dec,2022,53009,28275,29,81313
Pennsylvania,Feb,2010,0,47152,0,47152
Pennsylvania,Feb,2011,0,59739,0,59739
Pennsylvania,Feb,2012,67,89116,1,89184
Pennsylvania,Feb,2013,26,82258,278,82562
Pennsylvania,Feb,2014,47511,10231,0,57742
Pennsylvania,Feb,2015,51886,8727,0,60613
Pennsylvania,Feb,2016,61933,11791,0,73724
Pennsylvania,Feb,2017,54107,12734,37,66878
Pennsylvania,Feb,2018,51425,14849,34,66308
Pennsylvania,Feb,2019,47570,13297,17,60884
Pennsylvania,Feb,2020,53384,15473,53,68910
Pennsylvania,Feb,2021,54737,22421,40,77198
Pennsylvania,Feb,2022,50228,21323,50,71601
Pennsylvania,Feb,2023,47212,21088,35,68335
Pennsylvania,Jan,2010,0,47194,0,47194
Pennsylvania,Jan,2011,0,48470,0,48470
Pennsylvania,Jan,2012,19,66405,0,66424
Pennsylvania,Jan,2013,61,93619,304,93984
Pennsylvania,Jan,2014,207,48368,153,48728
Pennsylvania,Jan,2015,44966,7800,0,52766
Pennsylvania,Jan,2016,57355,10224,0,67579
Pennsylvania,Jan,2017,44199,10689,50,54938
Pennsylvania,Jan,2018,37308,10242,27,47577
Pennsylvania,Jan,2019,40144,11833,7,51984
Pennsylvania,Jan,2020,46160,13636,70,59866
Pennsylvania,Jan,2021,81592,32671,41,114304
Pennsylvania,Jan,2022,41927,18418,16,60361
Pennsylvania,Jan,2023,42802,19236,33,62071
Pennsylvania,Jul,2009,0,42530,0,42530
Pennsylvania,Jul,2010,2,42637,0,42639
Pennsylvania,Jul,2011,0,45503,0,45503
Pennsylvania,Jul,2012,40,63868,0,63908
Pennsylvania,Jul,2013,19,43118,217,43354
Pennsylvania,Jul,2014,34544,6543,0,41087
Pennsylvania,Jul,2015,38287,6885,0,45172
Pennsylvania,Jul,2016,46843,11793,19,58655
Pennsylvania,Jul,2017,37329,11694,159,49182
Pennsylvania,Jul,2018,33494,9738,29,43261
Pennsylvania,Jul,2019,33850,10017,27,43894
Pennsylvania,Jul,2020,77854,22276,68,100198
Pennsylvania,Jul,2021,46698,19944,28,66670
Pennsylvania,Jul,2022,42923,18194,40,61157
Pennsylvania,Jul,2023,33320,15865,19,49204
Pennsylvania,Jun,2009,1,43184,0,43185
Pennsylvania,Jun,2010,0,42880,0,42880
Pennsylvania,Jun,2011,1,46047,0,46048
Pennsylvania,Jun,2012,53,60185,0,60238
Pennsylvania,Jun,2013,20,45518,266,45804
Pennsylvania,Jun,2014,33261,6077,0,39338
Pennsylvania,Jun,2015,39007,6733,0,45740
Pennsylvania,Jun,2016,44677,11841,35,56553
Pennsylvania,Jun,2017,41408,11117,200,52725
Pennsylvania,Jun,2018,37280,10817,29,48126
Pennsylvania,Jun,2019,36023,10325,27,46375
Pennsylvania,Jun,2020,90652,24029,66,114747
Pennsylvania,Jun,2021,46571,19100,29,65700
Pennsylvania,Jun,2022,48211,20917,38,69166
Pennsylvania,Jun,2023,36449,18162,12,54623
Pennsylvania,Mar,2010,1,65524,0,65525
Pennsylvania,Mar,2011,0,71904,0,71904
Pennsylvania,Mar,2012,64,92661,0,92725
Pennsylvania,Mar,2013,43,84244,349,84636
Pennsylvania,Mar,2014,57940,10351,0,68291
Pennsylvania,Mar,2015,56770,10644,0,67414
Pennsylvania,Mar,2016,60489,12299,0,72788
Pennsylvania,Mar,2017,61207,15836,86,77129
Pennsylvania,Mar,2018,67756,19867,53,87676
Pennsylvania,Mar,2019,60068,16921,29,77018
Pennsylvania,Mar,2020,81319,22031,30,103380
Pennsylvania,Mar,2021,74896,30420,49,105365
Pennsylvania,Mar,2022,58010,25770,53,83833
Pennsylvania,Mar,2023,54232,25246,31,79509
Pennsylvania,May,2010,0,41483,0,41483
Pennsylvania,May,2011,3,48124,0,48127
Pennsylvania,May,2012,36,62046,0,62082
Pennsylvania,May,2013,20,49732,265,50017
Pennsylvania,May,2014,38001,6871,0,44872
Pennsylvania,May,2015,38419,6825,0,45244
Pennsylvania,May,2016,39963,8770,23,48756
Pennsylvania,May,2017,42646,11123,157,53926
Pennsylvania,May,2018,39765,10670,31,50466
Pennsylvania,May,2019,38050,10807,13,48870
Pennsylvania,May,2020,56455,16255,85,72795
Pennsylvania,May,2021,48158,19442,32,67632
Pennsylvania,May,2022,41014,17026,64,58104
Pennsylvania,May,2023,37238,17503,23,54764
Pennsylvania,Nov,2009,0,59769,0,59769
Pennsylvania,Nov,2010,1,67043,0,67044
Pennsylvania,Nov,2011,24,73464,0,73488
Pennsylvania,Nov,2012,50,78231,322,78603
Pennsylvania,Nov,2013,25,70428,184,70637
Pennsylvania,Nov,2014,57010,13907,22,70939
Pennsylvania,Nov,2015,62752,16297,0,79049
Pennsylvania,Nov,2016,66188,20487,42,86717
Pennsylvania,Nov,2017,54967,21597,44,76608
Pennsylvania,Nov,2018,49328,20463,24,69815
Pennsylvania,Nov,2019,49972,22212,39,72223
Pennsylvania,Nov,2020,75428,34686,29,110143
Pennsylvania,Nov,2021,47708,29011,25,76744
Pennsylvania,Nov,2022,45307,27505,28,72840
Pennsylvania,Oct,2009,0,55853,0,55853
Pennsylvania,Oct,2010,1,56795,0,56796
Pennsylvania,Oct,2011,26,62938,1,62965
Pennsylvania,Oct,2012,29,58116,201,58346
Pennsylvania,Oct,2013,16,58745,186,58947
Pennsylvania,Oct,2014,50150,10758,0,60908
Pennsylvania,Oct,2015,50119,10921,0,61040
Pennsylvania,Oct,2016,56836,16223,40,73099
Pennsylvania,Oct,2017,43923,15604,67,59594
Pennsylvania,Oct,2018,41412,14583,27,56022
Pennsylvania,Oct,2019,44371,17094,54,61519
Pennsylvania,Oct,2020,73607,29581,45,103233
Pennsylvania,Oct,2021,50185,25812,22,76019
Pennsylvania,Oct,2022,43318,22321,42,65681
Pennsylvania,Sep,2009,0,50144,0,50144
Pennsylvania,Sep,2010,0,51739,0,51739
Pennsylvania,Sep,2011,0,58431,0,58431
Pennsylvania,Sep,2012,27,53559,203,53789
Pennsylvania,Sep,2013,16,52691,172,52879
Pennsylvania,Sep,2014,42506,8823,0,51329
Pennsylvania,Sep,2015,42205,8762,0,50967
Pennsylvania,Sep,2016,46101,12697,31,58829
Pennsylvania,Sep,2017,39825,13222,48,53095
Pennsylvania,Sep,2018,36793,12563,36,49392
Pennsylvania,Sep,2019,40203,14471,33,54707
Pennsylvania,Sep,2020,68109,25277,46,93432
Pennsylvania,Sep,2021,44601,22537,34,67172
Pennsylvania,Sep,2022,40911,20583,38,61532
Pennsylvania,Sep,2023,35055,19948,26,55029
Tennessee,Apr,2010,12533,8066,0,20599
Tennessee,Apr,2011,13983,9779,0,23762
Tennessee,Apr,2012,15736,10927,0,26663
Tennessee,Apr,2013,19072,14798,0,33870
Tennessee,Apr,2014,16972,11316,0,28288
Tennessee,Apr,2015,19190,11361,0,30551
Tennessee,Apr,2016,22965,12049,0,35014
Tennessee,Apr,2017,23031,11521,1164,35716
Tennessee,Apr,2018,23325,12360,1329,37014
Tennessee,Apr,2019,21848,10619,1224,33691
Tennessee,Apr,2020,38309,19001,1974,59284
Tennessee,Apr,2021,39652,19833,2036,61521
Tennessee,Apr,2022,29042,16037,1805,46884
Tennessee,Apr,2023,27862,16636,1935,46433
Tennessee,Aug,2009,11855,9296,0,21151
Tennessee,Aug,2010,12546,10049,0,22595
Tennessee,Aug,2011,13887,12061,0,25948
Tennessee,Aug,2012,17328,15654,0,32982
Tennessee,Aug,2013,16500,14236,0,30736
Tennessee,Aug,2014,17136,14233,0,31369
Tennessee,Aug,2015,22983,15384,0,38367
Tennessee,Aug,2016,22737,16198,0,38935
Tennessee,Aug,2017,19965,14204,1191,35360
Tennessee,Aug,2018,20996,13165,1112,35273
Tennessee,Aug,2019,25754,14536,1540,41830
Tennessee,Aug,2020,35007,21069,1837,57913
Tennessee,Aug,2021,29364,18154,1745,49263
Tennessee,Aug,2022,27877,16463,1898,46238
Tennessee,Aug,2023,23835,15229,1630,40694
Tennessee,Dec,2009,16886,20554,0,37440
Tennessee,Dec,2010,18915,22001,0,40916
Tennessee,Dec,2011,24452,27923,0,52375
Tennessee,Dec,2012,37951,43721,0,81672
Tennessee,Dec,2013,24107,29742,0,53849
Tennessee,Dec,2014,30117,30298,0,60415
Tennessee,Dec,2015,51923,36311,0,88234
Tennessee,Dec,2016,36917,30997,1807,69721
Tennessee,Dec,2017,37860,28825,1984,68669
Tennessee,Dec,2018,34499,26987,1847,63333
Tennessee,Dec,2019,35893,26800,1899,64592
Tennessee,Dec,2020,40019,32201,2195,74415
Tennessee,Dec,2021,42865,30049,2596,75510
Tennessee,Dec,2022,40500,28530,2569,71599
Tennessee,Feb,2010,18309,12832,0,31141
Tennessee,Feb,2011,21069,13707,0,34776
Tennessee,Feb,2012,25658,17153,0,42811
Tennessee,Feb,2013,32630,23703,0,56333
Tennessee,Feb,2014,25694,17965,0,43659
Tennessee,Feb,2015,27069,16763,0,43832
Tennessee,Feb,2016,36439,18121,0,54560
Tennessee,Feb,2017,31982,16425,1559,49966
Tennessee,Feb,2018,31159,16929,1818,49906
Tennessee,Feb,2019,27213,14058,1500,42771
Tennessee,Feb,2020,32364,15464,1688,49516
Tennessee,Feb,2021,29633,17566,1760,48959
Tennessee,Feb,2022,32612,17688,2030,52330
Tennessee,Feb,2023,31754,16829,1961,50544
Tennessee,Jan,2010,12900,9816,0,22716
Tennessee,Jan,2011,15601,10436,0,26037
Tennessee,Jan,2012,18029,12590,0,30619
Tennessee,Jan,2013,34623,23963,0,58586
Tennessee,Jan,2014,17208,13754,0,30962
Tennessee,Jan,2015,22197,15007,0,37204
Tennessee,Jan,2016,30411,16571,0,46982
Tennessee,Jan,2017,23009,13583,1109,37701
Tennessee,Jan,2018,21023,12372,1125,34520
Tennessee,Jan,2019,22848,13776,1315,37939
Tennessee,Jan,2020,28938,14788,1507,45233
Tennessee,Jan,2021,46194,29203,2727,78124
Tennessee,Jan,2022,26275,15442,1623,43340
Tennessee,Jan,2023,28782,16472,1901,47155
Tennessee,Jul,2009,11526,7335,0,18861
Tennessee,Jul,2010,12405,8038,0,20443
Tennessee,Jul,2011,12455,8834,0,21289
Tennessee,Jul,2012,15308,11123,0,26431
Tennessee,Jul,2013,15367,10932,0,26299
Tennessee,Jul,2014,15442,10414,0,25856
Tennessee,Jul,2015,22803,12231,0,35034
Tennessee,Jul,2016,26276,16118,0,42394
Tennessee,Jul,2017,20279,11425,1125,32829
Tennessee,Jul,2018,19188,9840,1071,30099
Tennessee,Jul,2019,19494,10191,1116,30801
Tennessee,Jul,2020,42011,20831,2075,64917
Tennessee,Jul,2021,31906,15260,1650,48816
Tennessee,Jul,2022,28300,14569,1971,44840
Tennessee,Jul,2023,23702,12849,1494,38045
Tennessee,Jun,2009,10816,7062,0,17878
Tennessee,Jun,2010,11699,6858,0,18557
Tennessee,Jun,2011,12513,7998,0,20511
Tennessee,Jun,2012,14810,10732,0,25542
Tennessee,Jun,2013,14513,10657,0,25170
Tennessee,Jun,2014,14563,10004,0,24567
Tennessee,Jun,2015,18596,10241,0,28837
Tennessee,Jun,2016,22476,15194,0,37670
Tennessee,Jun,2017,23369,11558,1237,36164
Tennessee,Jun,2018,20805,10399,1821,33025
Tennessee,Jun,2019,20708,9777,1510,31995
Tennessee,Jun,2020,50593,21516,2293,74402
Tennessee,Jun,2021,30015,14389,1712,46116
Tennessee,Jun,2022,30112,15782,2142,48036
Tennessee,Jun,2023,24651,13369,1591,39611
Tennessee,Mar,2010,15605,10938,0,26543
Tennessee,Mar,2011,18753,11979,0,30732
Tennessee,Mar,2012,19732,14661,0,34393
Tennessee,Mar,2013,26152,21626,0,47778
Tennessee,Mar,2014,19944,15014,0,34958
Tennessee,Mar,2015,22617,14513,0,37130
Tennessee,Mar,2016,27951,14909,0,42860
Tennessee,Mar,2017,29369,15922,1526,46817
Tennessee,Mar,2018,32501,19418,1997,53916
Tennessee,Mar,2019,30728,15086,1463,47277
Tennessee,Mar,2020,49546,25157,2954,77657
Tennessee,Mar,2021,46941,25205,2628,74774
Tennessee,Mar,2022,36454,20535,2205,59194
Tennessee,Mar,2023,32348,18569,2001,52918
Tennessee,May,2010,11886,6961,0,18847
Tennessee,May,2011,12655,7927,0,20582
Tennessee,May,2012,14337,9980,0,24317
Tennessee,May,2013,16850,12546,0,29396
Tennessee,May,2014,15607,10039,0,25646
Tennessee,May,2015,18928,10314,0,29242
Tennessee,May,2016,19232,10394,0,29626
Tennessee,May,2017,22198,10745,1187,34130
Tennessee,May,2018,20549,10028,1205,31782
Tennessee,May,2019,20921,9885,1522,32328
Tennessee,May,2020,38522,17799,1869,58190
Tennessee,May,2021,31082,14602,1634,47318
Tennessee,May,2022,26402,12876,1737,41015
Tennessee,May,2023,25911,13591,1592,41094
Tennessee,Nov,2009,12301,15026,0,27327
Tennessee,Nov,2010,14304,17217,0,31521
Tennessee,Nov,2011,16350,21019,0,37369
Tennessee,Nov,2012,22221,28279,0,50500
Tennessee,Nov,2013,19267,24267,0,43534
Tennessee,Nov,2014,21010,24913,0,45923
Tennessee,Nov,2015,28815,24023,0,52838
Tennessee,Nov,2016,29502,25976,1719,57197
Tennessee,Nov,2017,31618,23889,1635,57142
Tennessee,Nov,2018,27015,22267,2998,52280
Tennessee,Nov,2019,27826,21101,1706,50633
Tennessee,Nov,2020,37467,31625,2298,71390
Tennessee,Nov,2021,33337,24647,2018,60002
Tennessee,Nov,2022,31059,23116,2180,56355
Tennessee,Oct,2009,12770,12309,0,25079
Tennessee,Oct,2010,12943,12387,0,25330
Tennessee,Oct,2011,13883,14326,0,28209
Tennessee,Oct,2012,16835,16902,0,33737
Tennessee,Oct,2013,15858,16070,0,31928
Tennessee,Oct,2014,19184,17453,0,36637
Tennessee,Oct,2015,24423,17480,0,41903
Tennessee,Oct,2016,23542,18514,1485,43541
Tennessee,Oct,2017,21614,16131,1285,39030
Tennessee,Oct,2018,20286,13725,1303,35314
Tennessee,Oct,2019,21973,15268,1342,38583
Tennessee,Oct,2020,33275,22568,1973,57816
Tennessee,Oct,2021,30555,19445,1856,51856
Tennessee,Oct,2022,26867,17176,1776,45819
Tennessee,Sep,2009,11365,9855,0,21220
Tennessee,Sep,2010,12033,10387,0,22420
Tennessee,Sep,2011,13175,12204,0,25379
Tennessee,Sep,2012,15153,14344,0,29497
Tennessee,Sep,2013,14814,13908,0,28722
Tennessee,Sep,2014,16841,14442,0,31283
Tennessee,Sep,2015,21223,14758,0,35981
Tennessee,Sep,2016,20721,15120,0,35841
Tennessee,Sep,2017,19219,13746,1042,34007
Tennessee,Sep,2018,18721,11942,1167,31830
Tennessee,Sep,2019,20638,13292,1314,35244
Tennessee,Sep,2020,31341,19732,1661,52734
Tennessee,Sep,2021,27447,17916,1668,47031
Tennessee,Sep,2022,28479,16418,1903,46800
Tennessee,Sep,2023,22481,15142,1597,39220
Texas,Apr,2010,24481,21343,595,46419
Texas,Apr,2011,31570,25708,898,58176
Texas,Apr,2012,36296,28840,1282,66418
Texas,Apr,2013,48822,39216,2164,90202
Texas,Apr,2014,38657,30379,2127,71163
Texas,Apr,2015,41412,29218,2447,73077
Texas,Apr,2016,45339,27823,2775,75937
Texas,Apr,2017,44994,28015,3098,76107
Texas,Apr,2018,41373,27019,3930,72322
Texas,Apr,2019,38994,24009,3451,66454
Texas,Apr,2020,93980,40921,5668,140569
Texas,Apr,2021,79802,39265,5959,125026
Texas,Apr,2022,64582,28526,4137,97245
Texas,Apr,2023,56795,28584,4022,89401
Texas,Aug,2009,24624,30487,523,55634
Texas,Aug,2010,25618,30875,598,57091
Texas,Aug,2011,30112,35200,865,66177
Texas,Aug,2012,40131,44238,1693,86062
Texas,Aug,2013,38576,45538,1583,85697
Texas,Aug,2014,38172,43507,2309,83988
Texas,Aug,2015,41503,40561,2433,84497
Texas,Aug,2016,42302,40269,3137,85708
Texas,Aug,2017,37277,34884,2093,74254
Texas,Aug,2018,37819,35212,2934,75965
Texas,Aug,2019,49804,36943,3855,90602
Texas,Aug,2020,77807,43770,5975,127552
Texas,Aug,2021,64118,37508,3965,105591
Texas,Aug,2022,57617,33989,4632,96238
Texas,Aug,2023,47559,30913,3810,82282
Texas,Dec,2009,38003,55742,607,94352
Texas,Dec,2010,43197,60696,728,104621
Texas,Dec,2011,55187,73202,1288,129677
Texas,Dec,2012,98886,108058,3699,210643
Texas,Dec,2013,56566,78068,2290,136924
Texas,Dec,2014,66280,78321,3420,148021
Texas,Dec,2015,107224,80247,4585,192056
Texas,Dec,2016,69163,69272,3641,142076
Texas,Dec,2017,70767,66779,4312,141858
Texas,Dec,2018,62560,56919,4482,123961
Texas,Dec,2019,69732,53386,4713,127831
Texas,Dec,2020,79774,58650,5211,143635
Texas,Dec,2021,89626,54657,5594,149877
Texas,Dec,2022,83157,52862,5546,141565
Texas,Feb,2010,36493,27823,939,65255
Texas,Feb,2011,41341,29888,868,72097
Texas,Feb,2012,54703,40563,1424,96690
Texas,Feb,2013,76087,52208,2437,130732
Texas,Feb,2014,55417,41550,2271,99238
Texas,Feb,2015,60204,39798,3091,103093
Texas,Feb,2016,72584,37980,3156,113720
Texas,Feb,2017,56786,33238,3083,93107
Texas,Feb,2018,55634,35889,4158,95681
Texas,Feb,2019,49130,28709,3663,81502
Texas,Feb,2020,60512,29259,3956,93727
Texas,Feb,2021,53772,27829,4217,85818
Texas,Feb,2022,66796,31364,4328,102488
Texas,Feb,2023,63700,29634,4277,97611
Texas,Jan,2010,27645,26553,746,54944
Texas,Jan,2011,34251,28911,774,63936
Texas,Jan,2012,38234,34319,1196,73749
Texas,Jan,2013,89130,60897,3015,153042
Texas,Jan,2014,39174,36808,2083,78065
Texas,Jan,2015,44153,36397,2852,83402
Texas,Jan,2016,72626,38396,3756,114778
Texas,Jan,2017,42697,31314,3040,77051
Texas,Jan,2018,40443,29960,3400,73803
Texas,Jan,2019,39240,27842,3727,70809
Texas,Jan,2020,53796,29103,4092,86991
Texas,Jan,2021,84022,47149,6067,137238
Texas,Jan,2022,58532,29742,4491,92765
Texas,Jan,2023,55982,29702,4323,90007
Texas,Jul,2009,23326,20778,584,44688
Texas,Jul,2010,25133,21903,559,47595
Texas,Jul,2011,28000,24870,760,53630
Texas,Jul,2012,35783,29918,1315,67016
Texas,Jul,2013,35456,29941,1487,66884
Texas,Jul,2014,32736,28145,2088,62969
Texas,Jul,2015,41237,27981,2300,71518
Texas,Jul,2016,50499,34266,4046,88811
Texas,Jul,2017,36913,27245,2653,66811
Texas,Jul,2018,35363,23141,2882,61386
Texas,Jul,2019,34215,21520,3002,58737
Texas,Jul,2020,96689,41060,6431,144180
Texas,Jul,2021,65203,29692,4281,99176
Texas,Jul,2022,60260,27696,4489,92445
Texas,Jul,2023,47650,23317,3888,74855
Texas,Jun,2009,23978,21010,39,45027
Texas,Jun,2010,24420,19503,549,44472
Texas,Jun,2011,28911,23268,766,52945
Texas,Jun,2012,34768,28889,1311,64968
Texas,Jun,2013,34302,30708,1566,66576
Texas,Jun,2014,34426,27426,2067,63919
Texas,Jun,2015,43199,27650,2432,73281
Texas,Jun,2016,46816,33501,4013,84330
Texas,Jun,2017,48895,29119,3000,81014
Texas,Jun,2018,39032,24252,3160,66444
Texas,Jun,2019,37592,22608,3351,63551
Texas,Jun,2020,121926,45845,6857,174628
Texas,Jun,2021,71295,30634,4550,106479
Texas,Jun,2022,69148,32349,5487,106984
Texas,Jun,2023,51381,24918,3800,80099
Texas,Mar,2010,31512,25440,765,57717
Texas,Mar,2011,39750,29342,972,70064
Texas,Mar,2012,47874,37409,1596,86879
Texas,Mar,2013,64439,49206,2553,116198
Texas,Mar,2014,49169,38758,2453,90380
Texas,Mar,2015,53371,36853,2987,93211
Texas,Mar,2016,55547,31794,2985,90326
Texas,Mar,2017,55983,34308,3702,93993
Texas,Mar,2018,60134,38853,5634,104621
Texas,Mar,2019,55222,31747,4092,91061
Texas,Mar,2020,147714,61827,5897,215438
Texas,Mar,2021,95320,47817,6098,149235
Texas,Mar,2022,82218,37664,5214,125096
Texas,Mar,2023,67368,32194,4370,103932
Texas,May,2010,24476,19923,557,44956
Texas,May,2011,29323,24239,767,54329
Texas,May,2012,34541,28197,1320,64058
Texas,May,2013,41105,34669,1948,77722
Texas,May,2014,37264,29032,2209,68505
Texas,May,2015,44935,29899,2679,77513
Texas,May,2016,39446,25424,2559,67429
Texas,May,2017,42366,27991,2991,73348
Texas,May,2018,37893,24419,3348,65660
Texas,May,2019,38714,23587,3118,65419
Texas,May,2020,83977,36456,5393,125826
Texas,May,2021,72175,32613,4744,109532
Texas,May,2022,61073,26898,3881,91852
Texas,May,2023,58444,27280,3780,89504
Texas,Nov,2009,27116,36125,466,63707
Texas,Nov,2010,31451,40228,614,72293
Texas,Nov,2011,35928,49253,904,86085
Texas,Nov,2012,52840,64903,2231,119974
Texas,Nov,2013,43195,57710,1701,102606
Texas,Nov,2014,47340,58551,2544,108435
Texas,Nov,2015,56941,51670,2532,111143
Texas,Nov,2016,58778,56057,3610,118445
Texas,Nov,2017,59840,51536,3450,114826
Texas,Nov,2018,44763,43276,3437,91476
Texas,Nov,2019,57252,41942,3592,102786
Texas,Nov,2020,78827,56265,5504,140596
Texas,Nov,2021,70441,44916,3960,119317
Texas,Nov,2022,63821,41578,3964,109363
Texas,Oct,2009,24638,32633,498,57769
Texas,Oct,2010,25858,33053,565,59476
Texas,Oct,2011,30160,38398,852,69410
Texas,Oct,2012,37556,44643,1584,83783
Texas,Oct,2013,36720,44769,1455,82944
Texas,Oct,2014,39725,44864,2317,86906
Texas,Oct,2015,43428,41157,2836,87421
Texas,Oct,2016,46518,44519,3763,94800
Texas,Oct,2017,41780,39297,3633,84710
Texas,Oct,2018,34646,31100,2972,68718
Texas,Oct,2019,41994,33957,3423,79374
Texas,Oct,2020,72591,44620,5042,122253
Texas,Oct,2021,67440,38737,4157,110334
Texas,Oct,2022,56594,33532,3676,93802
Texas,Sep,2009,21498,33233,411,55142
Texas,Sep,2010,24093,34038,529,58660
Texas,Sep,2011,29410,41207,760,71377
Texas,Sep,2012,36471,45464,1454,83389
Texas,Sep,2013,33690,45571,1469,80730
Texas,Sep,2014,34837,46899,1949,83685
Texas,Sep,2015,39567,45376,2578,87521
Texas,Sep,2016,37858,42308,2888,83054
Texas,Sep,2017,39119,39416,2768,81303
Texas,Sep,2018,33746,33087,2907,69740
Texas,Sep,2019,42688,35840,3736,82264
Texas,Sep,2020,68804,46463,4888,120155
Texas,Sep,2021,71702,41561,4300,117563
Texas,Sep,2022,54688,36257,4023,94968
Texas,Sep,2023,46450,35984,3761,86195
Virginia,Apr,2010,25259,18158,0,43417
Virginia,Apr,2011,15008,10407,0,25415
Virginia,Apr,2012,17649,12196,594,30439
Virginia,Apr,2013,20989,17416,866,39271
Virginia,Apr,2014,17184,13113,740,31037
Virginia,Apr,2015,18272,12038,686,30996
Virginia,Apr,2016,21709,13235,851,35795
Virginia,Apr,2017,29480,16844,1227,47551
Virginia,Apr,2018,20638,12759,3022,36419
Virginia,Apr,2019,20270,10699,2692,33661
Virginia,Apr,2020,40444,19116,4949,64509
Virginia,Apr,2021,34633,17980,4395,57008
Virginia,Apr,2022,26441,15143,3368,44952
Virginia,Apr,2023,25421,15125,3368,43914
Virginia,Aug,2009,10372,10198,0,20570
Virginia,Aug,2010,11857,10207,0,22064
Virginia,Aug,2011,12084,10470,0,22554
Virginia,Aug,2012,17146,14148,745,32039
Virginia,Aug,2013,17394,14938,742,33074
Virginia,Aug,2014,16034,13675,792,30501
Virginia,Aug,2015,18252,12733,793,31778
Virginia,Aug,2016,21108,15802,978,37888
Virginia,Aug,2017,20797,14926,1161,36884
Virginia,Aug,2018,18729,11694,2329,32752
Virginia,Aug,2019,23429,13458,3324,40211
Virginia,Aug,2020,36314,20016,4525,60855
Virginia,Aug,2021,25669,15787,3516,44972
Virginia,Aug,2022,23927,14134,3586,41647
Virginia,Aug,2023,20538,13005,3167,36710
Virginia,Dec,2009,11911,17572,0,29483
Virginia,Dec,2010,14577,17746,0,32323
Virginia,Dec,2011,19470,23046,84,42600
Virginia,Dec,2012,36554,39104,1829,77487
Virginia,Dec,2013,22960,27395,989,51344
Virginia,Dec,2014,24410,24225,1092,49727
Virginia,Dec,2015,41097,29651,1547,72295
Virginia,Dec,2016,32572,27619,1308,61499
Virginia,Dec,2017,31084,25165,3408,59657
Virginia,Dec,2018,26129,22048,3524,51701
Virginia,Dec,2019,37790,29539,8357,75686
Virginia,Dec,2020,36502,26668,4634,67804
Virginia,Dec,2021,33356,23898,4573,61827
Virginia,Dec,2022,32824,22955,4519,60298
Virginia,Feb,2010,14130,11132,0,25262
Virginia,Feb,2011,19068,12222,0,31290
Virginia,Feb,2012,24439,15704,833,40976
Virginia,Feb,2013,32229,23554,1341,57124
Virginia,Feb,2014,24248,16694,1131,42073
Virginia,Feb,2015,23999,15237,1040,40276
Virginia,Feb,2016,30085,15948,1133,47166
Virginia,Feb,2017,28434,16587,1170,46191
Virginia,Feb,2018,26596,15770,3483,45849
Virginia,Feb,2019,24579,12572,3168,40319
Virginia,Feb,2020,36608,20509,8746,65863
Virginia,Feb,2021,29404,16798,3930,50132
Virginia,Feb,2022,27730,15827,3433,46990
Virginia,Feb,2023,27299,15238,3617,46154
Virginia,Jan,2010,11513,10323,0,21836
Virginia,Jan,2011,13928,10089,0,24017
Virginia,Jan,2012,15822,11720,577,28119
Virginia,Jan,2013,34636,24775,1426,60837
Virginia,Jan,2014,16759,14172,716,31647
Virginia,Jan,2015,21023,14433,844,36300
Virginia,Jan,2016,27033,15699,922,43654
Virginia,Jan,2017,21375,14319,820,36514
Virginia,Jan,2018,19443,12248,2374,34065
Virginia,Jan,2019,20600,12813,3209,36622
Virginia,Jan,2020,36391,21424,9713,67528
Virginia,Jan,2021,41711,23650,5208,70569
Virginia,Jan,2022,23681,14124,3491,41296
Virginia,Jan,2023,26233,15043,3637,44913
Virginia,Jul,2009,11029,9065,0,20094
Virginia,Jul,2010,12207,8592,0,20799
Virginia,Jul,2011,13419,9388,0,22807
Virginia,Jul,2012,17361,12028,675,30064
Virginia,Jul,2013,15759,12570,631,28960
Virginia,Jul,2014,15727,11605,699,28031
Virginia,Jul,2015,19564,11481,738,31783
Virginia,Jul,2016,24671,16731,1064,42466
Virginia,Jul,2017,20688,13381,971,35040
Virginia,Jul,2018,18547,10039,2474,31060
Virginia,Jul,2019,19139,9731,2757,31627
Virginia,Jul,2020,44801,19538,5588,69927
Virginia,Jul,2021,26346,14418,3568,44332
Virginia,Jul,2022,25758,13491,3582,42831
Virginia,Jul,2023,20735,11824,3133,35692
Virginia,Jun,2009,9000,7836,0,16836
Virginia,Jun,2010,9347,6917,0,16264
Virginia,Jun,2011,10945,7884,0,18829
Virginia,Jun,2012,14451,10979,532,25962
Virginia,Jun,2013,16205,12574,597,29376
Virginia,Jun,2014,14711,11017,623,26351
Virginia,Jun,2015,16539,10126,733,27398
Virginia,Jun,2016,20132,15480,993,36605
Virginia,Jun,2017,22416,12706,959,36081
Virginia,Jun,2018,17812,9865,2376,30053
Virginia,Jun,2019,20006,9518,2825,32349
Virginia,Jun,2020,55177,21748,6338,83263
Virginia,Jun,2021,26685,14348,3645,44678
Virginia,Jun,2022,27252,14648,4171,46071
Virginia,Jun,2023,21984,12563,3363,37910
Virginia,Mar,2010,18718,11119,0,29837
Virginia,Mar,2011,18229,11780,0,30009
Virginia,Mar,2012,21304,14545,753,36602
Virginia,Mar,2013,28321,22841,1122,52284
Virginia,Mar,2014,23015,16781,904,40700
Virginia,Mar,2015,22865,15230,923,39018
Virginia,Mar,2016,26264,14622,1019,41905
Virginia,Mar,2017,29873,17754,1193,48820
Virginia,Mar,2018,30568,19180,4820,54568
Virginia,Mar,2019,29043,14550,3547,47140
Virginia,Mar,2020,51801,24208,6848,82857
Virginia,Mar,2021,42816,22192,5093,70101
Virginia,Mar,2022,31656,18081,4033,53770
Virginia,Mar,2023,28577,16656,3867,49100
Virginia,May,2010,15652,11525,0,27177
Virginia,May,2011,11938,8266,0,20204
Virginia,May,2012,14213,10795,551,25559
Virginia,May,2013,17007,13414,687,31108
Virginia,May,2014,15597,11102,686,27385
Virginia,May,2015,17065,9854,680,27599
Virginia,May,2016,18183,10896,758,29837
Virginia,May,2017,21697,12181,969,34847
Virginia,May,2018,18493,9958,2409,30860
Virginia,May,2019,17935,8821,2454,29210
Virginia,May,2020,36930,16775,4568,58273
Virginia,May,2021,26658,13588,3489,43735
Virginia,May,2022,24118,12268,3224,39610
Virginia,May,2023,22469,12389,3212,38070
Virginia,Nov,2009,11099,15971,0,27070
Virginia,Nov,2010,12715,16299,0,29014
Virginia,Nov,2011,14798,19089,0,33887
Virginia,Nov,2012,22826,28382,1208,52416
Virginia,Nov,2013,19170,24822,926,44918
Virginia,Nov,2014,19685,23164,898,43747
Virginia,Nov,2015,24052,22348,974,47374
Virginia,Nov,2016,29544,26823,1298,57665
Virginia,Nov,2017,26229,22897,3007,52133
Virginia,Nov,2018,22204,19747,3138,45089
Virginia,Nov,2019,27949,23374,5338,56661
Virginia,Nov,2020,35909,26638,4874,67421
Virginia,Nov,2021,28367,21788,3682,53837
Virginia,Nov,2022,27137,19880,3505,50522
Virginia,Oct,2009,12430,14753,0,27183
Virginia,Oct,2010,12655,12674,0,25329
Virginia,Oct,2011,13968,14629,0,28597
Virginia,Oct,2012,16759,17809,774,35342
Virginia,Oct,2013,17306,18458,859,36623
Virginia,Oct,2014,18009,17273,934,36216
Virginia,Oct,2015,20672,17008,908,38588
Virginia,Oct,2016,24337,20433,1269,46039
Virginia,Oct,2017,20450,16169,2637,39256
Virginia,Oct,2018,17662,13511,2438,33611
Virginia,Oct,2019,20887,15388,3146,39421
Virginia,Oct,2020,37867,22986,4606,65459
Virginia,Oct,2021,26469,18466,3477,48412
Virginia,Oct,2022,24372,16631,3310,44313
Virginia,Sep,2009,9887,11211,0,21098
Virginia,Sep,2010,11106,10776,0,21882
Virginia,Sep,2011,12701,12134,0,24835
Virginia,Sep,2012,17365,15658,726,33749
Virginia,Sep,2013,15952,16794,761,33507
Virginia,Sep,2014,16028,14835,754,31617
Virginia,Sep,2015,18720,13891,862,33473
Virginia,Sep,2016,20325,16687,954,37966
Virginia,Sep,2017,19676,15075,1100,35851
Virginia,Sep,2018,16923,12040,2448,31411
Virginia,Sep,2019,19517,13336,3231,36084
Virginia,Sep,2020,31327,19565,4105,54997
Virginia,Sep,2021,23679,16736,3504,43919
Virginia,Sep,2022,23514,14899,3420,41833
Virginia,Sep,2023,20489,14552,3110,38151
